1 1 1 1 1 1 1 1 1 1 1 1 1 1 1 1 1 1 1 1 1 1 1 1 1 1 1 1 1 1 1 1 1 1 1 1 1 1
1 1 1 1 1 1 1 3 3 3 3 3 3 3 3 3 5 6 6 6 6 6 6 6 6 6 6 6 6 7 3 3 3 3 1 1 1 1
1 1 1 1 1 1 1 5 6 6 6 6 6 6 7 3 8 0 0 0 0 4 4 4 4 4 4 4 4 10 3 1 1 1 1 1 1 1
1 1 1 1 1 1 1 8 0 0 0 0 0 0 9 3 8 0 0 0 9 3 3 3 3 3 3 3 3 3 3 1 1 1 1 1 1 1
1 3 5 6 6 6 6 0 0 0 0 0 0 0 9 3 8 0 0 0 9 3 5 6 6 6 6 6 6 7 3 1 1 1 1 1 1 1
1 3 2 4 4 4 0 0 0 0 0 0 0 0 9 3 8 0 0 0 9 3 8 0 0 0 0 0 0 9 3 1 1 1 1 1 1 1
1 3 3 3 3 3 8 0 0 0 0 0 0 0 9 3 8 0 0 0 9 3 8 0 0 0 0 0 0 9 3 1 1 1 1 1 1 1
1 3 5 6 7 3 2 4 4 4 4 4 4 4 10 3 2 4 4 4 10 3 8 0 0 0 0 0 0 9 3 1 1 1 1 1 1 1
1 3 8 0 9 3 3 3 3 3 3 3 3 3 3 3 3 3 3 3 3 3 8 0 0 0 0 0 0 9 3 1 1 1 1 1 1 1
1 3 8 0 0 6 6 6 6 6 6 6 6 6 7 3 5 6 6 6 7 3 8 0 0 0 0 0 0 9 3 1 1 1 1 1 1 1
1 3 8 0 0 0 0 0 0 0 0 0 0 0 9 3 8 0 0 0 9 3 8 0 0 0 0 0 0 9 3 1 1 1 1 1 1 1
1 3 8 0 0 0 0 0 0 0 0 0 0 0 9 3 8 0 0 0 9 3 8 0 0 0 0 0 0 9 3 1 1 1 1 1 1 1
1 3 2 4 4 4 4 4 4 4 4 4 4 4 10 3 2 4 4 4 10 3 2 4 4 4 4 4 4 10 3 1 1 1 1 1 1 1
1 3 3 3 3 3 3 3 3 3 3 3 3 3 3 3 3 3 3 3 3 3 3 3 3 3 3 3 3 3 3 1 1 1 1 1 1 1
1 3 5 6 6 6 6 6 6 6 6 6 6 6 7 3 5 6 6 6 6 6 6 6 6 6 6 6 6 7 3 1 1 1 1 1 1 1
1 3 8 0 0 0 0 0 0 0 0 0 0 0 9 3 8 0 0 0 0 0 0 0 0 0 0 0 0 9 3 1 1 1 1 1 1 1
1 3 8 0 0 0 0 0 0 0 0 0 0 0 9 3 8 0 0 0 0 0 0 0 0 0 0 0 0 9 3 1 1 1 1 1 1 1
1 3 2 4 4 4 4 4 4 4 4 4 4 4 10 3 2 4 4 4 4 4 4 4 4 4 4 4 4 10 3 1 1 1 1 1 1 1
1 3 3 3 3 3 3 3 3 3 3 3 3 3 3 3 3 3 3 3 3 3 3 3 3 3 3 3 3 3 3 1 1 1 1 1 1 1
1 1 1 1 1 1 1 1 1 1 1 1 1 1 1 1 1 1 1 1 1 1 1 1 1 1 1 1 1 1 1 1 1 1 1 1 1 1